...###....#
..##.#.#.##
.##..###..#
##...1....#
#......#..#
###..###..#
..#..#....#
.##.##.#.##
.#......##.
.#.....##..
.##..@.....
.#.....##..
