#..########
..##.....##
.##..###..#
##...1....#
#......#..#
#.#..###..#
#.#..#....#
#.#.##.#..#
#.......#.#
.#.....##1#
.##..@....#
###########
