#
#..#.###.#.#
#...#@##.#.
#..#..#..#.
#..##..#...
#....K....#
#.......#.#
#.###......
#.#.#..#...
#......#.##
#..##W.....
##....#####
#