...#.###.#.
#...#@##.#.
#..#..#..#.
...##..#...
#.........#
#.......#.#
#.###......
#.#.#..#...
#......#.##
#..##......
##....#####
