#
#..#.###.#.#
#...#@##.#.
#..#..#..#.
#..##..#...
#.........#
#.......#.#
#.###......
#.#.#..#...
#......#.##
#..##......
##....#####
#