------------#########
--#######---#.......#
--#.....#####.......#----############################
--#.................#----#...........H..............#
--#@.HR............7#----#..##...##...##...##7..##..#
--#.................#----#..##...##...##...##...##..#-------#########--------#######
--#.....#####.......#----#....2.........1...........#-------#.......#-------##.....##
--#######---#.......#----#..........................#-------#.......#-------#.......#
------------######..#----#.........................5#########.......#########...R...#
-----------------#..#----#..........................................%...............#
-----------------#..#----#.........................3................%........Z..J..T#
-----------------#..#----#............7.............................%...............#
---------#########..#----#.........................5#########.......#########...H...#
---------#..........#----#....1.....................#-------#...H...#-------#.......#
---------#...##.....#----#................2.........#-------#.......#-------##.....##
---------#....#.....#----#..##...##...##...##...##..#-------##.....##--------#######
---------#..........#----#..##...##...##...##...##..#--------#.....#
---------#.......#..#----#...................1......#--------#.....#
---------#.......##.#----#............7..........R..#--------#.....#
---------#.##.......#----#..#########################--------#.....#
---------#..#.......#----#..#--------------------------------#.....#
---------#......#...#----#..#--------------------------------#.....#
---------#......##..######..#--------------------------------#.....#
---------#..................#--------------------------------#.....#
---------#2...7...2........H#--------------------------------#.....#
---------####################--------------------------------#.....#
-------------------------------------------------------------#.....#
-------------------------------------------------------------#.....#
-------------------------------------------------------------#.....#
-------------------------------------------------------------#.....#
-------------------------------------------------------------#.....#
-------------------------------------------------------------#.....#
-------------------------------------------------------------#.....#
-------------------------------------------------------------#.....#
-------------------------------------------------------------#.....#
-------------------------------------------------------------#.....#
-------------------------------------------------------------#.....#
-------------------------------------------------------------#.....#
-------------------------------------------------------------#.....#
-------------------------------------------------------------#.....#
-------------------------------------------------------------#.....#
-------------------------------------------------------------#.....#
-------------------------------------------------------------#.....#
-------------------------------------------------------------#.....#
-------------------------------------------------------------#.....#
-------------------------------------------------------------#.....#
-------------------------------------------------------------#.....#
-------------------------------------------------------------#..8..#
-------------------------------------------------------------#######