###############
#5............#
#.............#
#.............#
#.............#
#.............#####
#.............%...#
#@......5....4%HHT#
#.............%...#
#.............#####
#.............#
#.............#
#.............#
#5............#
###############