#################################
#...............................#
#...............................#
#...............................#
#...............................#
#...............................#
#.....####.............####.....#
#.....#--#.............#--#.....#
#.....#--#.............#--#.....#
#.....####.............####.....#
#...............................#
#...............................#
#...............................#
#...............................##########
#...............................%........#
#...............................%........#
#@..............N...............%.......T#
#...............................%........#
#...............................%........#
#...............................##########
#...............................#
#...............................#
#...............................#
#.....####.............####.....#
#.....#--#.............#--#.....#
#.....#--#.............#--#.....#
#.....####.............####.....#
#...............................#
#...............................#
#...............................#
#...............................#
#...............................#
#################################