#########
#...T...#
#.......#
##.....##
#.......#
#.......#
#.......#
##.....##
#.......#
#.......#
#.......#
##.....##
#.......#
#.......#
#.......#
##.....##
#.......#
#.......#
#.......#
##.....##
#.......#
#.......#
#...@...#
#########

